1111111111111111111
1P000000CC00N0000C1
10N010N01000000CC01
10001000000100N0111
100N100011010N0000
1000100CC0010C000C1
10C0000000N10N00P01
100C001010C0C000N01
1C000000E00N000C001
1111111111111111111
