1111111111111
1P0N0000CC001
10010N0100001
1C000000N0011
10C00E000N001
1111111111111
